
SO            ./4k.xpm   
F   000,000,000               
N                                                                          ./4k.xpm
C              000  ,   000 , 000

W    ./4k.xpm



E ./4k.xpm
11111111111111111111111111
10000000001100000000000011
10110000011100000000000111
100100000000000000000000101111111
111111111011000001110000000000001
10000000001100001110110111111111
11110111111111011100000010001
11110111111111011101010000001
11000000110101011000000100011
100000000000000011000000110001
100000000000000011010100001001
110000011101010111110111110W111
11110111 1110101 101111010001
11111111 1111111 11111111111