
SO            ./path_to_the_south_texture    
F   100,21,80                   
N                                                                          ./path_to_the_north_texture
C              225  ,   30 , 23

W    ./path_to_the_west_texture



E ./path_to_the_east_texture
11111111111111111111111111
10000000001100000000000011
10110000011100000000000011
100100000000000000000000101111111
111111111011000001110000000000001
10000000001100001110111111111111
11110111111111011100000010001
11110111111111011101010010001
11000000110101011000000100011
100000000000000011000000110001
10000000000000001101010N001001
1100000111010101111101111100111
11110111 1110101 101111010001
11111111 1111111 1111111101111
                         1

 1
101
 1