
N                                            ./textures/4k.xpm 
SO            ./textures/4k.xpm       
F   000,  000, 000          
C              000  ,   000 , 000

W    ./textures/4k.xpm 


E ./textures/4k.xpm 

           1111111111111111111111111
           1000000000110000000000001
           1011000001110000000000001
        11 1001000000000000000000001
11111111101100000111000000000000111111
100000000011000001110111111111111
11110111111111011100000010001
11110111111111011101010010001
11000000110101011100000010001
10000000000000001100000010001
10000000000000001101010010001
11000001110101011111011110N0111
11110111 1110101 101111010001
11111111 1111111 111111111111